sdhs
sdflhk
sdf;sl;dfjs
lkdjdf

1111111111
1000000N01
1000000001
1111111111