sdhs
sdflhk
sdf;sl;dfjs
lkdj;j


1111111111111111111111111
1000000000110000000000001
1110110000011100000000001
1001000000000000000000001
1111111110110000000000001
1000000000110011101111111
1111011111111101110000011
1111011111111101 11101011
1100000011010101110100011
1000000000000000110010001
100N000000000000110101011   //player pos
1100000111010101110101111
11110111 1110101 10111111
11110111 1110101 10111111
11110111 1110101 10111111
11110111 1110101 10111111
11110111 1110101 10111111
11110111 1110101 10111111
11111111 1111111 11111111

//this should be square when played