NO textures/walls/wallN.xpm      
WE textures/walls/wallW.xpm
SO textures/walls/wallS512.xpm
EA textures/walls/wallE.xpm

F 128,128,128

C 255,255,255

1111111111111111111111
1000000000000000000011
1000111110001111100011
1010000010001000S00011
1010111111111011D10011
1010000000000000100011
1000111000111000110011
1000011111000000000011
1000010001000000000011
1000010011000000000011
1011111110111111111001
1010000000000000000011
1010111D11111111111011
1000000000000000000011
1000111000111000110011
1000000000000000000011
1011110111110111111011
1000000000000000000011
1000000000000000000011
1111111111111111111111

111111111111111
100000000000011
100011100011001
101000111001001
100011100011001
100000000000011
101111011111001
100000000000011
100000000000011
101111011111001
100000000000011
111111111111111