F 220,100,0
C 220,100,0

NO ./assets/leaves.xpm
SO ./assets/test.xpm
WE ./assets/flowers.xpm
EA ./assets/banana.xpm

1111111111111111111
1000000000000000001
1000000000000100001
1000001000000000001
10000000000000N0001
1111111111111111111