NO    ./assets/leaves.xpm     
SO     ./assets/test.xpm    
WE     ./assets/flowers.xpm    
EA     ./assets/coin.xpm    

F   255,  0  ,  255   
C   0  ,  255  ,  255    

1111111111111111111
1000000000000000N01
1000000000000100001
1000001000000000001
1000000000000000001
1111111111111111111