F 220,100,0
C 225,30,0

NO ./assets/leaves.xpm
SO ./assets/test.xpm
WE ./assets/flowers.xpm
EA ./assets/banana.xpm
NO./assets/flowers.xpm
EA ./assets/banana.xpm

1111111111111111111
1000000000000000001
1000000000000100001
1000001000000000001
1000000000000000001
1111111111111111111
                1111111
                100N001
                1111111