sdhs
sdflhk
sdf;sl;dfjs
lkdj;j


        1111111111111111111111111
        1000000000110000000000001
     111011000001110000000000001
     1001000000000000000000001111
111111111011000001110000000000001
100000000011000001110111111111111
111101111111110111000000100011
1111011111111101 11101010010001
110000001101010111000000100011
10000000000000001100000010001
100000000000000011010100100011
110000011101010111110111100111
11110111 1110101 101111010001
11111111 1111111 111111111111