F 220,100,0
C 225,30,0

NO ./assets/leaves.xpm
SO ./assets/test.xpm
WE ./assets/flowers.xpm
EA ./assets/banana.xpm


        1111111111111111111111111
        10000N0000110000000000001
     111011000001110000000000001
     1001000000000000000000001111
111111111011000001110000000000001
100000000011000001110111111111111
111101111111110111000000100011
1111011111111101 11101010010001
110000001101010111000000100011
10000000000000001100N00010001
100000000000000011010100100011
11000001110101011111011110N0111
11110111 1110101 101111010001
11111111 1111111 111111111111