
NO ./assets/leaves.xpm
SO ./assets/test.xpm
WE ./assets/flowers.xpm
EA ./assets/tile.xpm

F 220,100,0
C 225,30,0

11111111111111111111111111111111111
11000100000000010001000000000000001
11000100000000010000000000000000001
1111110000W000010001000000000000001
11000100000000011111000000000000001
11000000000000011111000000000000001
11000100000000010000000000000000001
11000100000000000000000000000000001
11000100000000010001000000000000001
11111111111111111111111111111111111