sdhs
sdflhk
sdf;sl;dfjs
lkdj;j


1111111111
10010f0001
1000000N01
1111111111